"aa" = (/turf/unsimulated/ground,/area/coldwar/forest)
"ab" = (/turf/unsimulated/floor/road{icon_state = "concreteroad"},/area/coldwar/forest)
"ac" = (/obj/structure/target_stake,/turf/unsimulated/floor/road{icon_state = "concreteroad"},/area/coldwar/forest)
"ad" = (/obj/structure/closet/crate/wood,/turf/unsimulated/ground,/area/coldwar/forest)
"ae" = (/obj/structure/table/greenmetal,/turf/unsimulated/floor/road{icon_state = "concreteroad"},/area/coldwar/forest)
"af" = (/obj/random/tree,/turf/unsimulated/ground,/area/coldwar/forest)
"ag" = (/turf/simulated/wall/tentcloth,/area/coldwar/forest)
"ah" = (/obj/structure/closet/crate/wood,/turf/simulated/floor/tiled/dark,/area/coldwar/forest)
"ai" = (/obj/structure/closet/crate/ammo,/turf/simulated/floor/tiled/dark,/area/coldwar/forest)
"aj" = (/obj/machinery/light/coldtint{dir = 1},/turf/simulated/floor/tiled/dark,/area/coldwar/forest)
"ak" = (/turf/simulated/floor/tiled/dark,/area/coldwar/forest)
"al" = (/turf/simulated/floor/tiled,/area/coldwar/forest)
"am" = (/obj/structure/sign/soviet_flag,/turf/simulated/wall/tentcloth,/area/coldwar/forest)
"an" = (/obj/machinery/light/coldtint{dir = 8},/turf/simulated/floor/tiled,/area/coldwar/forest)
"ao" = (/obj/structure/bed/foldbed,/obj/effect/landmark/start{name = "SA Boevoi Medik"},/turf/simulated/floor/tiled/dark,/area/coldwar/forest)
"ap" = (/obj/structure/bed/foldbed,/obj/effect/landmark/start{name = "SA Ingenieur"},/turf/simulated/floor/tiled/dark,/area/coldwar/forest)
"aq" = (/obj/structure/bed/foldbed,/obj/effect/landmark/start{name = "SA Pomoshnik Granatometchika"},/turf/simulated/floor/tiled/dark,/area/coldwar/forest)
"ar" = (/obj/structure/bed/foldbed,/obj/effect/landmark/start{name = "SA Pomoshnik Vzvodnogo Pulemetchika"},/turf/simulated/floor/tiled/dark,/area/coldwar/forest)
"as" = (/obj/structure/bed/foldbed,/obj/effect/landmark/start{name = "SA Pulemetchik"},/turf/simulated/floor/tiled/dark,/area/coldwar/forest)
"at" = (/obj/machinery/light/coldtint{dir = 4},/turf/simulated/floor/tiled,/area/coldwar/forest)
"au" = (/obj/structure/curtain/tent,/turf/simulated/floor/tiled,/area/coldwar/forest)
"av" = (/obj/structure/bed/foldbed,/obj/effect/landmark/start{name = "SA Radiotelefonist"},/turf/simulated/floor/tiled/dark,/area/coldwar/forest)
"aw" = (/obj/structure/bed/foldbed,/obj/effect/landmark/start{name = "SA Saper"},/turf/simulated/floor/tiled/dark,/area/coldwar/forest)
"ax" = (/obj/structure/bed/foldbed,/obj/effect/landmark/start{name = "SA Snaiper"},/turf/simulated/floor/tiled/dark,/area/coldwar/forest)
"ay" = (/obj/structure/bed/foldbed,/obj/effect/landmark/start{name = "SA Shtabnoi Radiotelefonist"},/turf/simulated/floor/tiled/dark,/area/coldwar/forest)
"az" = (/obj/structure/bed/foldbed,/obj/effect/landmark/start{name = "SA Strelok"},/turf/simulated/floor/tiled/dark,/area/coldwar/forest)
"aA" = (/obj/structure/bed/foldbed,/obj/effect/landmark/start{name = "SA Strelok-Granatometchik"},/turf/simulated/floor/tiled/dark,/area/coldwar/forest)
"aB" = (/obj/structure/bed/foldbed,/obj/effect/landmark/start{name = "SA Vzvodny Pulemetchik"},/turf/simulated/floor/tiled/dark,/area/coldwar/forest)
"aC" = (/obj/structure/bed/foldbed,/obj/effect/landmark/start{name = "SA Zamestitel Komandira Otdeleniya"},/turf/simulated/floor/tiled/dark,/area/coldwar/forest)
"aD" = (/obj/structure/bed/foldbed,/obj/effect/landmark/start{name = "SA Zamestitel Komandira Vzvoda"},/turf/simulated/floor/tiled/dark,/area/coldwar/forest)
"aE" = (/obj/machinery/light/coldtint,/turf/simulated/floor/tiled/dark,/area/coldwar/forest)
"aF" = (/obj/structure/bed/foldbed,/turf/simulated/floor/tiled/dark,/area/coldwar/forest)
"aG" = (/obj/machinery/light/coldtint,/obj/effect/landmark/start{name = "KGB Komandir Elementa"},/turf/simulated/floor/tiled/dark,/area/coldwar/forest)
"aH" = (/obj/effect/landmark/start{name = "KGB Operator"},/turf/simulated/floor/tiled/dark,/area/coldwar/forest)
"aI" = (/obj/effect/landmark/start{name = "KGB Pulemetchik"},/turf/simulated/floor/tiled/dark,/area/coldwar/forest)
"aJ" = (/obj/effect/landmark/start{name = "KGB Shturmovik"},/turf/simulated/floor/tiled/dark,/area/coldwar/forest)
"aK" = (/obj/effect/landmark/start{name = "KGB Snaiper"},/turf/simulated/floor/tiled/dark,/area/coldwar/forest)
"aL" = (/obj/structure/closet/crate/wood,/obj/item/device/flashlight/wpflare,/obj/item/device/flashlight/wpflare,/obj/item/device/flashlight/wpflare,/obj/item/device/flashlight/wpflare,/obj/item/device/flashlight/wpflare,/obj/item/device/flashlight/wpflare,/obj/item/device/flashlight/wpflare,/obj/item/device/flashlight/wpflare,/obj/item/device/flashlight/wpflare,/obj/item/device/flashlight/wpflare,/obj/item/device/flashlight/wpflare,/obj/item/device/flashlight/wpflare,/obj/item/device/flashlight/wpflare,/obj/item/device/flashlight/wpflare,/obj/item/device/flashlight/wpflare,/obj/item/device/flashlight/wpflare,/obj/item/device/flashlight/wpflare,/obj/item/device/flashlight/wpflare,/obj/item/device/flashlight/wpflare,/obj/item/device/flashlight/wpflare,/obj/item/device/flashlight/wpflare,/obj/item/device/flashlight/wpflare,/obj/item/device/flashlight/wpflare,/obj/item/device/flashlight/wpflare,/obj/item/device/flashlight/wpflare,/obj/item/device/flashlight/wpflare,/obj/item/device/flashlight/wpflare,/obj/item/device/flashlight/wpflare,/obj/item/device/flashlight/wpflare,/obj/item/device/flashlight/wpflare,/obj/machinery/light/small/red{dir = 8},/turf/simulated/floor/plating,/area/coldwar/forest)
"aM" = (/obj/structure/closet/crate/ammo,/obj/item/ammo_magazine/c545x39m,/obj/item/ammo_magazine/c545x39m,/obj/item/ammo_magazine/c545x39m,/obj/item/ammo_magazine/c545x39m,/obj/item/ammo_magazine/c545x39m,/obj/item/ammo_magazine/c545x39m,/obj/item/ammo_magazine/c545x39m,/obj/item/ammo_magazine/c545x39m,/obj/item/ammo_magazine/c545x39m,/obj/item/ammo_magazine/c545x39m,/obj/item/ammo_magazine/c545x39m,/obj/item/ammo_magazine/c545x39m,/obj/item/ammo_magazine/c545x39m,/obj/item/ammo_magazine/c545x39m,/obj/item/ammo_magazine/c545x39m,/obj/item/ammo_magazine/c545x39m,/obj/item/ammo_magazine/c545x39m,/obj/item/ammo_magazine/c545x39m,/obj/item/ammo_magazine/c545x39m,/obj/item/ammo_magazine/c545x39m,/obj/item/ammo_magazine/c545x39m,/obj/item/ammo_magazine/c545x39m,/obj/item/ammo_magazine/c545x39m,/turf/simulated/floor/plating,/area/coldwar/forest)
"aN" = (/obj/structure/closet/crate/generic,/obj/machinery/light/small/red{dir = 4},/obj/item/ammo_magazine/ags30x29mm,/obj/item/ammo_magazine/ags30x29mm,/obj/item/ammo_magazine/ags30x29mm,/obj/item/ammo_magazine/ags30x29mm,/obj/item/weapon/mg_tripod/ags_17,/obj/item/weapon/mg_disassembled/ags_17,/turf/simulated/floor/plating,/area/coldwar/forest)
"aO" = (/obj/item/weapon/gun/launcher/oneuse/rpg18/rpg22,/obj/item/weapon/gun/launcher/oneuse/rpg18/rpg22,/obj/item/weapon/gun/launcher/oneuse/rpg18/rpg22,/obj/item/weapon/gun/launcher/oneuse/rpg18/rpg22,/obj/item/weapon/gun/launcher/oneuse/rpg18/rpg22,/obj/item/weapon/gun/launcher/oneuse/rpg18/rpg22,/obj/item/weapon/gun/launcher/oneuse/rpg18/rpg22,/obj/structure/closet/crate/ammo{name = "RPG-18 crate"},/obj/item/weapon/grenade/frag/satchelwp,/obj/item/weapon/grenade/frag/satchelwp,/obj/item/weapon/grenade/frag/satchelwp,/obj/item/weapon/grenade/frag/satchelwp,/obj/item/weapon/mine/pfm1,/obj/item/weapon/mine/pfm1,/obj/item/weapon/mine/pfm1,/obj/item/weapon/mine/pfm1,/obj/item/weapon/mine/pfm1,/obj/item/weapon/mine/pfm1,/turf/simulated/floor/plating,/area/coldwar/forest)
"aP" = (/obj/structure/closet/crate/ammo,/obj/item/weapon/storage/fancy/ammo_can/soviet/x762x54,/obj/item/ammo_magazine/c762x54b,/obj/item/ammo_magazine/c762x54b,/obj/item/ammo_magazine/c762x54b,/obj/item/ammo_magazine/c762x54b,/obj/item/ammo_magazine/c762x54b,/obj/item/ammo_magazine/c762x54b,/turf/simulated/floor/plating,/area/coldwar/forest)
"aQ" = (/obj/item/ammo_casing/rpg_missile/rg7,/obj/item/ammo_casing/rpg_missile/rg7,/obj/item/ammo_casing/rpg_missile/rg7,/obj/item/ammo_casing/rpg_missile/rg7,/obj/item/ammo_casing/rpg_missile/rg7,/obj/item/ammo_casing/rpg_missile/rg7,/obj/item/ammo_casing/rpg_missile/rg7,/obj/item/ammo_casing/rpg_missile/rg7,/obj/item/ammo_casing/rpg_missile/rg7,/obj/item/ammo_casing/rpg_missile/rg7,/obj/item/ammo_casing/rpg_missile/rg7,/obj/item/ammo_casing/rpg_missile/rg7,/obj/item/ammo_casing/rpg_missile/rg7,/obj/item/ammo_casing/rpg_missile/rg7,/obj/item/ammo_casing/rpg_missile/rg7,/obj/item/ammo_casing/rpg_missile/rg7,/obj/item/ammo_casing/rpg_missile/rg7,/obj/item/ammo_casing/rpg_missile/rg7,/obj/structure/closet/crate/ammo{name = "VOG-25 crate"},/turf/simulated/floor/plating,/area/coldwar/forest)
"aR" = (/obj/structure/closet/crate/ammo{name = "F1 crate"},/obj/item/weapon/grenade/smokebomb/wp,/obj/item/weapon/grenade/smokebomb/wp,/obj/item/weapon/grenade/smokebomb/wp,/obj/item/weapon/grenade/smokebomb/wp,/obj/item/weapon/grenade/smokebomb/wp,/obj/item/weapon/grenade/smokebomb/wp,/obj/item/weapon/grenade/smokebomb/wp,/obj/item/weapon/grenade/smokebomb/wp,/obj/item/weapon/grenade/smokebomb/wp,/obj/item/weapon/grenade/smokebomb/wp,/obj/item/weapon/grenade/smokebomb/wp,/obj/item/weapon/grenade/smokebomb/wp,/obj/item/weapon/grenade/smokebomb/wp,/obj/item/weapon/grenade/smokebomb/wp,/obj/item/weapon/grenade/smokebomb/wp,/obj/item/weapon/grenade/smokebomb/wp,/obj/item/weapon/grenade/smokebomb/wp,/obj/item/weapon/grenade/smokebomb/wp,/obj/item/weapon/grenade/smokebomb/wp,/obj/item/weapon/grenade/smokebomb/wp,/obj/item/weapon/grenade/fire/molotov,/obj/item/weapon/grenade/fire/molotov,/obj/item/weapon/grenade/fire/molotov,/obj/item/weapon/grenade/fire/molotov,/obj/item/weapon/grenade/fire/molotov,/obj/item/weapon/grenade/fire/molotov,/obj/item/weapon/grenade/fire/molotov,/obj/item/weapon/grenade/fire/molotov,/obj/item/weapon/grenade/fire/molotov,/turf/simulated/floor/plating,/area/coldwar/forest)
"aS" = (/obj/structure/closet/crate/ammo,/obj/item/ammo_magazine/c762x54s/tr,/obj/item/ammo_magazine/c762x54s/tr,/obj/item/ammo_magazine/c762x54s/tr,/obj/item/ammo_magazine/c762x54s/tr,/obj/item/ammo_magazine/c762x54s/tr,/obj/item/ammo_magazine/c762x54s/tr,/obj/item/ammo_magazine/c762x54s/tr,/obj/item/ammo_magazine/c762x54s/tr,/obj/item/ammo_magazine/c762x54s/tr,/obj/item/ammo_magazine/c762x54s/tr,/obj/item/ammo_magazine/c762x54s/tr,/obj/item/ammo_magazine/c762x54s/tr,/obj/item/ammo_magazine/c762x54s/tr,/obj/item/ammo_magazine/c762x54s/tr,/obj/item/ammo_magazine/c762x54s/tr,/obj/item/ammo_magazine/c762x54s/tr,/obj/item/ammo_magazine/c762x54s/tr,/obj/item/ammo_magazine/c762x54s/tr,/obj/item/ammo_magazine/c762x54s/tr,/obj/item/ammo_magazine/c762x54s/tr,/obj/item/ammo_magazine/c762x54s/tr,/turf/simulated/floor/plating,/area/coldwar/forest)
"aT" = (/obj/structure/closet/crate/ammo{name = "VOG-25 crate"},/obj/item/weapon/grenade/frag/ugl/vog25,/obj/item/weapon/grenade/frag/ugl/vog25,/obj/item/weapon/grenade/frag/ugl/vog25,/obj/item/weapon/grenade/frag/ugl/vog25,/obj/item/weapon/grenade/frag/ugl/vog25,/obj/item/weapon/grenade/frag/ugl/vog25,/obj/item/weapon/grenade/frag/ugl/vog25,/obj/item/weapon/grenade/frag/ugl/vog25,/obj/item/weapon/grenade/smokebomb/ugl/vog25,/obj/item/weapon/grenade/smokebomb/ugl/vog25,/obj/item/weapon/grenade/smokebomb/ugl/vog25,/obj/item/weapon/grenade/smokebomb/ugl/vog25,/obj/item/weapon/grenade/smokebomb/ugl/vog25,/obj/item/weapon/grenade/smokebomb/ugl/vog25,/obj/item/weapon/grenade/frag/ugl/vog25,/turf/simulated/floor/plating,/area/coldwar/forest)
"aU" = (/obj/structure/closet/crate/wood,/obj/item/stack/medical/tourniquet,/obj/item/stack/medical/tourniquet,/obj/item/stack/medical/tourniquet,/obj/item/stack/medical/tourniquet,/obj/item/stack/medical/tourniquet,/obj/item/stack/medical/tourniquet,/obj/item/stack/medical/tourniquet,/obj/item/stack/medical/tourniquet,/obj/item/stack/medical/tourniquet,/obj/item/stack/medical/tourniquet,/obj/item/weapon/gauze_pack/woundseal/wp,/obj/item/weapon/gauze_pack/woundseal/wp,/obj/item/weapon/gauze_pack/woundseal/wp,/obj/item/weapon/gauze_pack/woundseal/wp,/obj/item/weapon/gauze_pack/woundseal/wp,/obj/item/weapon/gauze_pack/woundseal/wp,/obj/item/weapon/gauze_pack/woundseal/wp,/obj/item/weapon/gauze_pack/woundseal/wp,/obj/item/weapon/gauze_pack/woundseal/wp,/obj/item/weapon/gauze_pack/woundseal/wp,/turf/simulated/floor/plating,/area/coldwar/forest)
"aV" = (/obj/structure/closet/crate/ammo{name = "armor crate"},/obj/item/clothing/suit/storage/vest/coldwar/soviet/a6b3,/obj/item/clothing/suit/storage/vest/coldwar/soviet/a6b3,/obj/item/clothing/suit/storage/vest/coldwar/soviet/a6b3,/obj/item/clothing/suit/storage/vest/coldwar/soviet/a6b3,/obj/item/clothing/suit/storage/vest/coldwar/soviet/a6b3,/obj/item/clothing/suit/storage/vest/coldwar/soviet/a6b2lifchik,/obj/item/clothing/suit/storage/vest/coldwar/soviet/a6b2lifchik,/obj/item/clothing/suit/storage/vest/coldwar/soviet/a6b2lifchik,/obj/item/clothing/suit/storage/vest/coldwar/soviet/a6b2lifchik,/obj/item/clothing/suit/storage/vest/coldwar/soviet/a6b2lifchik/alt,/obj/item/clothing/suit/armor/vest/coldwar/a6b2,/turf/simulated/floor/plating,/area/coldwar/forest)
"aW" = (/obj/item/weapon/storage/fancy/ammo_can/soviet/x54539,/obj/item/weapon/storage/fancy/ammo_can/soviet/x54539,/obj/item/weapon/storage/fancy/ammo_can/soviet/x54539,/obj/item/weapon/storage/fancy/ammo_can/soviet/x54539,/obj/item/weapon/storage/fancy/ammo_can/soviet/x54539,/obj/item/weapon/storage/fancy/ammo_can/soviet/x54539,/obj/structure/closet/crate/ammo,/turf/simulated/floor/plating,/area/coldwar/forest)
"aX" = (/obj/structure/closet/crate/ammo{name = "utility crate"},/obj/item/weapon/handcuffs,/obj/item/weapon/handcuffs,/obj/item/weapon/handcuffs,/obj/item/weapon/handcuffs,/obj/item/weapon/handcuffs,/obj/item/weapon/handcuffs,/obj/item/weapon/handcuffs,/obj/item/weapon/handcuffs,/obj/item/weapon/handcuffs,/obj/item/weapon/handcuffs,/obj/item/weapon/storage/belt/holster/sheath/soviet74,/obj/item/weapon/storage/belt/holster/sheath/soviet74,/obj/item/weapon/storage/belt/holster/sheath/soviet74,/obj/item/weapon/storage/belt/holster/sheath/soviet74,/obj/item/weapon/storage/belt/holster/sheath/soviet74,/obj/item/ammo_magazine/a9x18,/obj/item/ammo_magazine/a9x18,/obj/item/ammo_magazine/a9x18,/obj/item/ammo_magazine/a9x18,/obj/item/ammo_magazine/a9x18,/obj/item/ammo_magazine/a9x18,/obj/item/ammo_magazine/a9x18,/obj/item/ammo_magazine/a9x18,/obj/item/ammo_magazine/a9x18,/obj/item/clothing/mask/gas/coldwar/gp7,/obj/item/clothing/mask/gas/coldwar/gp7,/obj/item/clothing/mask/gas/coldwar/pmg,/turf/simulated/floor/plating,/area/coldwar/forest)
"aY" = (/obj/structure/closet/crate/ammo{name = "armor crate"},/obj/item/clothing/accessory/storage/coldwar/lifchik,/obj/item/clothing/accessory/storage/coldwar/lifchik,/obj/item/clothing/accessory/storage/coldwar/lifchik,/obj/item/clothing/accessory/storage/coldwar/lifchik,/obj/item/clothing/accessory/storage/coldwar/lifchik,/obj/item/clothing/accessory/storage/coldwar/lifchik,/obj/item/clothing/accessory/storage/coldwar/lifchik,/obj/item/clothing/accessory/storage/coldwar/lifchik,/obj/item/clothing/accessory/storage/coldwar/lifchik,/obj/item/clothing/accessory/storage/coldwar/lifchik,/obj/item/clothing/accessory/storage/coldwar/lifchik,/obj/item/clothing/accessory/storage/coldwar/lifchik,/obj/item/clothing/accessory/storage/coldwar/lifchik,/obj/item/clothing/accessory/storage/coldwar/lifchik,/obj/item/clothing/accessory/storage/coldwar/lifchik,/obj/item/clothing/accessory/storage/coldwar/lifchik/alt,/obj/item/clothing/accessory/storage/coldwar/lifchik/alt,/obj/item/clothing/accessory/storage/coldwar/lifchik/alt,/obj/item/clothing/accessory/storage/coldwar/lifchik/alt,/turf/simulated/floor/plating,/area/coldwar/forest)
"aZ" = (/obj/structure/closet/crate/wood,/obj/item/weapon/gauze_pack/ipp,/obj/item/weapon/gauze_pack/ipp,/obj/item/weapon/gauze_pack/ipp,/obj/item/weapon/gauze_pack/ipp,/obj/item/weapon/gauze_pack/ipp,/obj/item/weapon/gauze_pack/ipp,/obj/item/weapon/gauze_pack/ipp,/obj/item/weapon/gauze_pack/ipp,/obj/item/weapon/gauze_pack/ipp,/obj/item/weapon/gauze_pack/ipp,/obj/item/weapon/gauze_pack/ipp,/obj/item/weapon/gauze_pack/ipp,/obj/item/weapon/gauze_pack/ipp,/obj/item/weapon/gauze_pack/ipp,/obj/item/weapon/gauze_pack/ipp,/obj/item/weapon/gauze_pack/ipp,/obj/item/weapon/gauze_pack/ipp,/obj/item/weapon/gauze_pack/ipp,/obj/item/weapon/gauze_pack/ipp,/obj/item/weapon/gauze_pack/ipp,/obj/item/weapon/gauze_pack/ipp,/obj/item/weapon/gauze_pack/ipp,/obj/item/weapon/gauze_pack/ipp,/obj/item/weapon/gauze_pack/ipp,/obj/item/weapon/gauze_pack/ipp,/obj/item/weapon/gauze_pack/ipp,/obj/item/weapon/gauze_pack/ipp,/obj/item/weapon/gauze_pack/ipp,/obj/item/weapon/gauze_pack/ipp,/obj/item/weapon/gauze_pack/ipp,/turf/simulated/floor/plating,/area/coldwar/forest)
"ba" = (/obj/structure/closet/crate/ammo,/obj/item/ammo_magazine/c545x39b,/obj/item/ammo_magazine/c545x39b,/obj/item/ammo_magazine/c545x39b,/obj/item/ammo_magazine/c545x39b,/obj/item/ammo_magazine/c545x39b,/obj/item/ammo_magazine/c545x39b,/obj/item/ammo_magazine/c545x39b,/obj/item/ammo_magazine/c545x39b,/obj/item/ammo_magazine/c545x39b,/obj/item/ammo_magazine/c545x39b,/obj/item/ammo_magazine/c545x39b,/obj/item/ammo_magazine/c545x39b,/obj/item/ammo_magazine/c545x39b,/obj/item/ammo_magazine/c545x39b,/obj/item/ammo_magazine/c545x39b,/obj/item/ammo_magazine/c545x39b,/obj/item/ammo_magazine/c545x39b,/obj/item/ammo_magazine/c545x39b,/obj/item/ammo_magazine/c545x39b,/obj/item/ammo_magazine/c545x39b,/obj/item/ammo_magazine/c545x39b,/obj/item/ammo_magazine/c545x39b,/obj/item/ammo_magazine/c545x39b,/obj/item/ammo_magazine/c545x39b,/obj/item/ammo_magazine/c545x39b,/obj/machinery/light/small/red{dir = 4},/turf/simulated/floor/plating,/area/coldwar/forest)
"bb" = (/obj/structure/sign/soviet_flag,/obj/structure/barricade/metal,/turf/simulated/floor/tiled/dark,/area/coldwar/forest)
"bc" = (/obj/machinery/door/unpowered/simple/coldwar/metal/steel/wpnco,/turf/simulated/floor/tiled/dark,/area/coldwar/forest)
"bd" = (/obj/effect/landmark{name = "Observer-start"},/turf/unsimulated/floor/road{icon_state = "concreteroad"},/area/coldwar/forest)
"be" = (/obj/effect/landmark{name = "JoinLate"},/turf/unsimulated/floor/road{icon_state = "concreteroad"},/area/coldwar/forest)

(1,1,1) = {"
aaaaaaaaaaaaaaaaaaaaaaaaaaaaaaaaaaaaaaaaaaaaaaaaaaaaaaaaaaaaaaaaaaaaaaaaaaaaaaaaaaaaaaaaaaaaaaaaaaaa
aaaaaaaaaaaaaaaaaaaaaaaaaaaaaaaaaaaaaaaaaaaaaaaaaaaaaaaaaaaaaaaaaaaaaaaaaaaaaaaaaaaaaaaaaaaaaaaaaaaa
aaaaaaaaaaaaaaaaaaaaaaaaaaaaaaaaaaaaaaaaaaaaaaaaaaaaaaaaaaaaaaaaaaaaaaaaaaaaaaaaaaaaaaaaaaaaaaaaaaaa
aaaaaaaaaaaaaaaaaaaaaaaaaaaaaaaaaaaaaaaaaaaaaaaaaaaaaaaaaaaaaaaaaaaaaaaaaaaaaaaaaaaaaaaaaaaaaaaaaaaa
aaaaaaaaaaaaaaaaaaaaaaaaaaaaaaaaaaaaaaaaaaaaaaaaaaaaaaaaaaaaaaaaaaaaaaaaaaaaaaaaaaaaaaaaaaaaaaaaaaaa
aaaaaaaaaaaaaaaaaaaaaaaaaaaaaaaaaaaaaaaaaaaaaaaaaaaaaaaaaaaaaaaaaaaaaaaaaaaaaaaaaaaaaaaaaaaaaaaaaaaa
aaaaaaaaaaaaaaaaaaaaaaaaaaaaaaaaaaaaaaaaaaaaaaaaaaaaaaaaaaaaaaaaaaaaaaaaaaaaaaaaaaaaaaaaaaaaaaaaaaaa
aaaaaaaaaaaaaaaaaaaaaaaaaaaaaaaaaaaaaaaaaaaaaaaaaaaaaaaaaaaaaaaaaaaaaaaaaaaaaaaaaaaaaaaaaaaaaaaaaaaa
aaaaaaaaaaaaaaaaaaaaaaaaaaaaaaaaaaaaaaaaaaaaaaaaaaaaaaaaaaaaaaaaaaaaaaaaaaaaaaaaaaaaaaaaaaaaaaaaaaaa
aaaaaaaaaaaaaaaaaaaaaaaaaaaaaaaaaaaaaaaaaaaaaaaaaaaaaaaaaaaaaaaaaaaaaaaaaaaaaaaaaaaaaaaaaaaaaaaaaaaa
aaaaaaaaaaaaaaaaaaaaaaaaaaaaaaaaaaaaaaaaaaaaaaaaaaaaaaaaaaaaaaaaaaaaaaaaaaaaaaaaaaaaaaaaaaaaaaaaaaaa
aaaaaaaaaaaaaaaaaaaaaaaaaaaaaaaaaaaaaaaaaaaaaaaaaaaaaaaaaaaaaaaaaaaaaaaaaaaaaaaaaaaaaaaaaaaaaaaaaaaa
aaaaaaaaaaaaaaaaaaaaaaaaaaaaaaaaaaaaaaaaaaaaaaaaaaaaaaaaaaaaaaaaaaaaaaaaaaaaaaaaaaaaaaaaaaaaaaaaaaaa
aaaaaaaaaaaaaaaaaaaaaaaaaaaaaaaaaaaaaaaaaaaaaaaaaaaaaaaaaaaaaaaaaaaaaaaaaaaaaaaaaaaaaaaaaaaaaaaaaaaa
aaaaaaaaaaaaaaaaaaaaaaaaaaaaaaaaaaaaaaaaaaaaaaaaaaaaaaaaaaaaaaaaaaaaaaaaaaaaaaaaaaaaaaaaaaaaaaaaaaaa
aaaaaaaaaaaaaaaaaaaaaaaaaaaaaaaaaaaaaaaaaaaaaaaaaaaaaaaaaaaaaaaaaaaaaaaaaaaaaaaaaaaaaaaaaaaaaaaaaaaa
aaaaaaaaaaaaaaaaaaaaaaaaaaaaaaaaaaaaaaaaaaaaaaaaaaaaaaaaaaaaaaaaaaaaaaaaaaaaaaaaaaaaaaaaaaaaaaaaaaaa
aaaaaaaaaaaaaaaaaaaaaaaaaaaaaaaaaaaaaaaaaaaaaaaaaaaaaaaaaaaaaaaaaaaaaaaaaaaaaaaaaaaaaaaaaaaaaaaaaaaa
aaaaaaaaaaaaaaaaaaaaaaaaaaaaaaaaaaaaaaaaaaaaaaaaaaaaaaaaaaaaaaaaaaaaaaaaaaaaaaaaaaaaaaaaaaaaaaaaaaaa
aaaaaaaaaaaaaaaaaaaaaaaaaaaaaaaaaaaaaaaaaaaaaaaaaaaaaaaaaaaaaaaaaaaaaaaaaaaaaaaaaaaaaaaaaaaaaaaaaaaa
aaaaaaaaaaaaaaaaaaaaaaaaaaaaaaaaaaaaaaaaaaaaaaaaaaaaaaaaaaaaaaaaaaaaaaaaaaaaaaaaaaaaaaaaaaaaaaaaaaaa
aaaaaaaaaaaaaaaaaaaaaaaaaaaaaaaaaaaaaaaaaaaaaaaaaaaaaaaaaaaaaaaaaaaaaaaaaaaaaaaaaaaaaaaaaaaaaaaaaaaa
aaaaaaaaaaaaaaaaaaaaaaaaaaaaaaaaaaaaaaaaaaaaaaaaaaaaaaaaaaaaaaaaaaaaaaaaaaaaaaaaaaaaaaaaaaaaaaaaaaaa
aaaaaaaaaaaaaaaaaaaaaaaaaaaaaaaaaaaaaaaaaaaaaaaaaaaaaaaaaaaaaaaaaaaaaaaaaaaaaaaaaaaaaaaaaaaaaaaaaaaa
aaaaaaaaaaaaaaaaaaaaaaaaaaaaaaaaaaaaaaaaaaaaaaaaaaaaaaaaaaaaaaaaaaaaaaaaaaaaaaaaaaaaaaaaaaaaaaaaaaaa
aaaaaaaaaaaaaaaaaaaaaaaaaaaaaaaaaaaaaaaaaaaaaaaaaaaaaaaaaaaaaaaaaaaaaaaaaaaaaaaaaaaaaaaaaaaaaaaaaaaa
aaaaaaaaaaaaaaaaaaaaaaaaaaaaaaaaaaaaaaaaaaaaaaaaaaaaaaaaaaaaaaaaaaaaaaaaafagagagagagagagagagagagafaa
aaaaaaaaaaaaaaaaabababababababababaaaaaaaaaaaaaaaaaaaaaaaaaaaaaaaaaaaaaaagagahahaiaiajakakakakagagaa
aaaaaaaaaaaaaaaaababababababacababaaaaaaaaaaaaaaaaaaaaaaaaaaaaaaaaaaaaaaagalalalalalalalalalalalagaa
aaaaaaaaaaaaaaaaabababababababababaaaaaaaaaaaaaaaaaaaaaaaaaaaaaaaaaaaaaaamanaoalapalaqalaralasatagaa
aaaaaaaaaaaaaaaaabababababababababaaaaaaaaaaaaaaaaaaaaaaababababababababaualalalalalalalalalalalagaa
aaaaaaaaaaaaaaaaabababababababababaaaaaaaaaaaaaaaaaaaaaaababababababababaualavalawalaxalayalazalagaa
aaaaaaaaaaaaaaaaabababababababababaaaaaaaaaaaaaaaaaaaaaaababababababababaualalalalalalalalakalalagaa
aaaaaaaaaaaaaaaaabababababababababaaaaaaaaaaaaaaaaaaaaaaabababaaaaaaaaaaamanaAalaBalaCalaDalazatagaa
aaaaaaaaaaaaaaaaabababababababababaaaaaaaaaaaaaaaaaaaaaaabababaaaaaaaaaaagalalalalalalalalalalalagaa
aaaaaaaaaaaaaaaaabababacabababababaaagagagagagagagaaaaaaabababaaaaaaaaaaagagahahaiaiaEakakakakagagaa
aaaaaaaaaaaaaaaaabababababababababaaagaLaMaMaMaNagaaaaaaabababaaaaaaaaaaafagagagagagagagagagagagafaa
aaaaaaaaaaaaaaaaabababababababababaaagaOakakakaPagaaaaaaabababaaaaaaaaaaaaaaaaaaaaaaaaaaaaaaaaaaaaaa
aaaaaaaaaaaaaaaaabacabababababacabaaagaQakaRakaSagaaaaaaabababaaaaaaaaaaafagagagagagagagagagagagafaa
aaaaaaaaaaaaaaaaabababababababababaaagaTakaUakaVagaaaaaaabababaaaaaaaaaaagagahahaiaiajakakakakagagaa
aaaaaaaaaaaaaaaaabababababababababaaagaWakaXakaYagaaaaaaabababaaaaaaaaaaagalalalalalalalalalalalagaa
aaaaaaaaaaaaaaaaaeaeaeaeaeaeaeaeaeaaagaZakakakbaagaaaaaaabababaaaaaaaaaaamanazalaAalaFalaxalaFatagaa
aaaaaaaaaaaaadadaeabababaebdbeabaeaaagagbbbcbbagagaaaaaaababababababababaualalalalalalalalalalalagaa
aaaaaaaaaaaaaaaaaaabababaaabababaaaaaaaaabababaaaaaaaaaaababababababababaualaAalazalaqalazalawalagaa
aaaaaaaaaaaaaaaaaaabababababababababababababababababababababababababababaualalalalalalalalalalalagaa
aaaaaaaaaaaaaaaaaaababababababababababababababababababababababaaaaaaaaaaamanazalavalaFalasalaAatagaa
aaaaaaaaaaaaaaaaaaababababababababababababababababababababababaaaaaaaaaaagalalalalalalalalalalalagaa
aaaaaaaaaaaaaaaaaaaaaaaaaaaaaaaaaaaaaaaaaaaaaaaaaaaaaaaaaaaaaaaaaaaaaaaaagagahahaiaiaGaHaIaJaKagagaa
aaaaaaaaaaaaaaaaaaaaaaaaaaaaaaaaaaaaaaaaaaaaaaaaaaaaaaaaaaaaaaaaaaaaaaaaafagagagagagagagagagagagafaa
aaaaaaaaaaaaaaaaaaaaaaaaaaaaaaaaaaaaaaaaaaaaaaaaaaaaaaaaaaaaaaaaaaaaaaaaaaaaaaaaaaaaaaaaaaaaaaaaaaaa
"}
